Month,ORG,IOR,NR,Total,Missing
Oct 2023,202,35,163,400,74
Nov 2023,167,60,125,352,73
Dec 2023,122,26,36,184,98
Jan 2024,252,17,52,321,99
Feb 2024,155,18,73,246,108
Mar 2024,153,28,118,299,134
Apr 2024,93,18,73,184,111
May 2024,169,10,61,240,163
Jun 2024,91,9,46,146,171
Jul 2024,138,12,64,214,209
Aug 2024,168,23,103,294,184
Sep 2024,223,14,137,374,175
